00,00,00,00,00,01,00,00,00,00,00,00,00,00,00,00,00,00,00,00,00,00,06
00,00,04,00,00,00,00,00,00,00,00,04,00,00,00,00,00,00,00,00,17,10,12
00,00,00,00,00,00,00,00,00,00,01,00,00,00,00,00,00,00,00,21,19,05,05
00,00,00,00,00,00,00,00,00,00,00,00,02,10,10,16,00,00,00,23,05,05,05
00,00,00,00,00,00,00,02,10,10,10,20,05,03,08,08,18,04,14,19,05,05,05
00,00,00,00,00,00,06,05,15,05,05,03,09,00,00,00,11,22,05,05,05,05,05
00,00,00,00,04,00,07,08,08,08,09,00,00,00,00,01,06,05,05,05,05,05,05
00,00,01,00,00,00,00,00,00,00,00,00,00,11,00,14,12,05,05,05,05,05,05
00,00,00,00,11,00,04,00,00,00,00,00,00,24,13,05,05,05,05,05,05,05,05
00,00,00,00,00,00,00,00,00,00,17,10,10,05,05,05,05,05,05,05,05,05,05